1 7 638 2467 891 3456 5204 1175 2771 
1 4 2771 2080 3300 5168 
1 4 5168 138 5147 5150 
1 9 2822 5202 2142 5192 1330 1615 1542 232 2771 
1 4 5150 799 3278 5118 
1 10 98 135 3010 3633 5138 48 148 5175 2243 2771 
1 9 2822 1839 5183 5173 1226 2455 5133 2329 98 
1 3 5115 1104 889 
1 11 4993 1310 1135 2269 109 2283 534 3105 1509 5029 3085 
1 13 4993 380 90 280 2878 3537 3514 3522 4817 4805 2324 2606 3524 
1 7 1463 297 4554 4536 1074 976 2172 
1 8 4675 1637 3768 545 1368 4625 3523 4608 
1 9 85 317 4474 4454 1749 1250 4466 4487 3399 
1 6 3399 4445 1720 1765 2264 3152 
1 6 2582 1383 121 1881 3587 3152 
1 7 2582 839 989 385 986 3803 2172 
1 8 4608 577 3218 4548 1405 2469 1208 2172 
1 11 4608 577 4563 3011 94 51 1968 3430 4425 3325 4392 
1 7 2172 3803 2387 1778 2640 1863 4369 
1 6 2582 4390 587 2475 4370 4369 
1 5 4369 2280 590 1852 2054 
1 9 4392 2076 3279 1648 4365 3740 1688 4340 3509 
1 12 3152 3587 4330 952 4302 2276 1707 1467 3323 4199 2255 4169 
1 11 2054 4280 3442 4236 3286 2369 2856 178 528 4101 758 
1 6 4169 2510 804 1328 4171 2369 
1 15 2599 4246 3249 3637 4205 4185 20 895 1267 3066 1242 2801 1039 4161 4169 
1 5 758 3704 22 588 1721 
1 13 1200 2482 2810 884 4118 815 2220 3591 4040 2192 4023 3993 3979 
1 28 566 3894 1287 3172 1497 3907 202 3909 2203 1902 1309 3926 3224 2549 2862 3950 2825 507 3963 2677 1826 3376 3956 3960 3971 3725 1939 3979 
1 25 1200 2482 3237 195 110 134 1377 2396 2391 3580 3141 872 1828 2412 2855 756 3440 3881 202 3335 3895 3172 1287 3894 566 
1 10 4631 3250 4630 1617 2008 4572 3443 1915 4533 1455 
1 4 1455 3171 4478 1993 
1 6 1455 4549 1091 3024 4595 2102 
1 6 1993 3294 3714 1257 3264 2102 
1 9 4631 3250 4630 2800 4635 349 1861 4595 2102 
1 14 2102 3051 1867 3052 3702 1971 4737 1166 3451 556 1575 3469 3156 1837 
1 12 476 3646 1460 4757 1181 4784 4791 2661 2168 707 4845 1837 
1 18 2102 1020 1165 1327 3384 4676 1446 2019 131 532 4701 939 2633 252 4714 1179 3646 476 
1 4 977 399 2781 633 
1 8 633 125 1284 3434 2354 84 1253 1551 
1 4 2354 1156 3207 4541 
1 7 4541 1086 55 2395 1675 2634 3244 
1 7 1551 4419 285 3680 4384 4367 320 
1 8 320 3070 4325 4306 543 4265 2561 358 
1 4 358 4206 2921 1695 
1 8 1066 120 2183 4999 4969 3400 2614 2253 
1 24 249 3541 3016 4856 376 2646 3142 1935 379 3377 2795 4802 406 759 1254 4819 1974 2910 666 2016 1814 152 1007 2253 
1 4 1665 458 2557 2722 
1 9 789 4964 3031 1098 583 344 1067 45 2836 
1 10 3422 1355 618 3228 1107 2908 3775 2152 2956 2411 
1 16 2411 959 1950 235 4449 3418 362 3161 600 1453 2867 4580 2223 469 1426 4665 
1 17 3422 3463 631 4357 2087 3108 444 1847 1495 4496 1002 615 1628 1437 2424 3287 1426 
1 9 3422 3344 830 3726 4198 3291 975 2756 1738 
1 13 363 2287 215 2765 1247 1062 2786 981 3217 1766 1690 2956 2411 
1 10 363 1335 305 4038 2949 3054 901 2085 3139 3271 
1 12 1738 3471 2166 4072 3219 3689 1900 2043 1856 3964 3750 267 
1 5 4431 4417 1894 3293 3734 
1 7 1894 88 2386 2217 3096 3673 3283 
1 5 4488 4481 4463 1792 4431 
1 4 4431 502 4405 867 
1 6 4431 127 3671 4472 2507 3673 
1 8 4687 828 2026 2182 3159 627 2229 4833 
1 6 911 2173 3650 531 3289 5002 
1 6 5101 1150 2349 3273 1036 5002 
1 9 911 3322 2502 5121 3627 2270 2205 3712 5171 
1 8 5171 1155 806 3266 1277 296 5203 5219 
1 7 5219 1522 5207 2461 2214 250 1622 
1 9 1622 3396 5166 246 2041 5146 3045 2702 1374 
1 12 261 5224 2703 1466 2591 5222 2674 3708 18 5194 2780 2522 
1 9 2522 907 814 5162 2134 2163 3709 153 113 
